1111111111
1000000001
1001110001
1001110001
1010001001
1001100011
1001100001
1000001101
1000100001
1111111111
